-	ー
,	、
.	。
/	・
//	……
;	っ
[	「
]	」
~	～
a	あ
b;	ばった
ba	ば
bd	べん
be	べ
bh	ぶう
bi	び
bj	ぶん
bk	びん
bl	ぼん
bo	ぼ
bp	ぼう
bq	ばい
bu	ぶ
bw	べい
bx	ばう
bya	びゃ
byd	びぇん
bye	びぇ
byf	びゅう
byj	びゅん
byl	びょん
byo	びょ
byp	びょう
byq	びゃい
byu	びゅ
byw	びぇい
byx	びゃう
byz	びゃん
bz	ばん
c;	ちゃった
ca	ちゃ
cd	ちぇん
ce	ちぇ
ch	ちゅう
ci	ち
cj	ちゅん
ck	ちん
cl	ちょん
co	ちょ
cp	ちょう
cq	ちゃい
cu	ちゅ
cw	ちぇい
cx	ちゃう
cz	ちゃん
d;	だった
da	だ
dc	では
dd	でん
de	で
dga	ぢゃ
dgd	ぢぇん
dge	ぢぇ
dgh	ぢゅう
dgi	ぢ
dgk	ぢん
dgo	ぢょ
dgp	ぢょう
dgq	ぢゃい
dgu	ぢゅ
dgw	ぢぇい
dgx	ぢゃう
dgz	ぢゃん
dh	づう
di	でぃ
dj	づん
dk	でぃん
dl	どん
dm	でも
dn	どの
do	ど
dp	どう
dq	だい
dr	どれ
ds	です
dt	でた
du	づ
dvh	どぅー
dvj	どぅん
dvu	どぅ
dw	でい
dx	だう
dyf	でゅー
dyj	でゅん
dyu	でゅ
dz	だん
e	え
fa	ふぁ
fd	ふぇん
fe	ふぇ
fh	ふう
fi	ふぃ
fj	ふん
fk	ふぃん
fl	ふぉん
fn	ふぁん
fo	ふぉ
fp	ふぉー
fq	ふぁい
fu	ふ
fw	ふぇい
fx	ふぁう
fz	ふぁん
g;	がった
ga	が
gd	げん
ge	げ
gh	ぐう
gi	ぎ
gj	ぐん
gk	ぎん
gl	ごん
go	ご
gp	ごう
gq	がい
gu	ぐ
gw	げい
gx	がう
gya	ぎゃ
gyd	ぎぇん
gye	ぎぇ
gyf	ぎゅう
gyj	ぎゅん
gyl	ぎょん
gyo	ぎょ
gyp	ぎょう
gyq	ぎゃい
gyu	ぎゅ
gyw	ぎぇい
gyx	ぎゃう
gyz	ぎゃん
gz	がん
h;	はった
ha	は
hd	へん
he	へ
hga	ひゃ
hgd	ひぇん
hge	ひぇ
hgh	ひゅう
hgj	ひゅん
hgl	ひょん
hgo	ひょ
hgp	ひょう
hgq	ひゃい
hgu	ひゅ
hgw	ひぇい
hgx	ひゃう
hgz	ひゃん
hh	ふゅう
hi	ひ
hk	ひん
hl	ほん
ho	ほ
hp	ほう
hq	はい
hu	ふゅ
hw	へい
hx	はう
hz	はん
i	い
j;	じい
ja	じゃ
jc	じゅん
jd	じぇん
je	じぇ
jf	じゅ
jg	じゅう
ji	じ
jj	じゅん
jk	じん
jl	じょん
jo	じょ
jp	じょう
jq	じゃい
ju	じゅ
jw	じぇい
jx	じゃう
jz	じゃん
k;	かった
ka	か
kb	から
kc	く
kd	けん
ke	け
kf	き
kga	きゃ
kgd	きぇん
kge	きぇ
kgh	きゅう
kgj	きゅん
kgl	きょん
kgo	きょ
kgp	きょう
kgq	きゃい
kgu	きゅ
kgw	きぇい
kgx	きゃう
kgz	きゃん
kh	くう
ki	き
kj	くん
kk	きん
kl	こん
km	かも
kn	この
ko	こ
kp	こう
kq	かい
kr	これ
ks	きん
kt	こと
ku	く
kv	くる
kw	けい
kx	かう
ky	きた
kz	かん
l;	あった
la	ぁ
lc	いる
ld	ありません
le	ぇ
li	ぃ
lm	→
ln	←
lo	ぉ
lq	あい
lr	ある
ls	あります
lt	いた
lu	ぅ
lwa	ゎ
lx	あう
lya	ゃ
lyo	ょ
lyu	ゅ
lz	あん
m;	まった
ma	ま
mb	むん
mc	まで
md	めん
me	め
mf	む
mga	みゃ
mgd	みぇん
mge	みぇ
mgh	みゅう
mgj	みゅん
mgl	みょん
mgo	みょ
mgp	みょう
mgq	みゃい
mgu	みゅ
mgw	みぇい
mgx	みゃう
mgz	みゃん
mh	むう
mi	み
mj	むん
mk	みん
ml	もん
mm	まま
mn	もの
mo	も
mp	もう
mq	まい
mr	める
ms	ます
mt	もと
mu	む
mv	また
mw	めい
mx	まう
my	みた
mz	まん
n;	なった
na	な
nb	なら
nc	など
nd	ねん
ne	ね
nf	ぬ
nga	にゃ
ngd	にぇん
nge	にぇ
ngh	にゅう
ngj	にゅん
ngl	にょん
ngo	にょ
ngp	にょう
ngq	にゃい
ngu	にゅ
ngw	にぇい
ngx	にゃう
ngz	にゃん
nh	ぬう
ni	に
nj	ぬん
nk	にん
nl	のん
nm	にも
nn	なの
no	の
np	のう
nq	ない
nr	なる
ns	なります
nt	のと
nu	ぬ
nv	には
nw	ねい
nx	なう
nz	なん
o	お
pa	ぱ
pc	ぽう
pd	ぺん
pe	ぺ
pf	ぷ
pga	ぴゃ
pgd	ぴぇん
pge	ぴぇ
pgh	ぴゅう
pgj	ぴゅん
pgl	ぴょん
pgo	ぴょ
pgp	ぴょう
pgq	ぴゃい
pgu	ぴゅ
pgw	ぴぇい
pgx	ぴゃう
pgz	ぴゃん
ph	ぷう
pi	ぴ
pj	ぷん
pk	ぴん
pl	ぽん
po	ぽ
pp	ぽう
pq	ぱい
pu	ぷ
pw	ぺい
px	ぱう
pz	ぱん
q	ん
r;	らった
ra	ら
rd	れん
re	れ
rh	るう
ri	り
rj	るん
rk	りん
rl	ろん
rn	らん
ro	ろ
rp	ろう
rq	らい
rr	れる
rs	られます
rt	れた
ru	る
rw	れい
rx	らう
rya	りゃ
ryd	りぇん
rye	りぇ
ryf	りゅう
ryj	りゅん
ryl	りょん
ryo	りょ
ryp	りょう
ryq	りゃい
ryu	りゅ
ryw	りぇい
ryx	りゃう
ryz	りゃん
rz	らん
s;	しい
sa	さ
sc	せい
sd	せん
se	せ
sf	せ
sh	すう
si	し
sj	すん
sk	しん
sl	そん
sm	します
sn	その
so	そ
sp	そう
sq	さい
sr	する
ss	させ
st	した
su	す
sv	それ
sw	せい
sx	さう
sz	さん
t;	たった
ta	た
tc	とは
td	てん
te	て
th	とぅー
ti	てぃ
tj	とぅん
tk	てぃん
tl	とん
tm	ため
tn	たん
to	と
tp	とう
tq	たい
tr	てる
tsa	つぁ
tsc	つぇい
tsd	つぇん
tse	つぇ
tsf	つぇ
tsh	つう
tsi	つぃ
tsj	つん
tsk	つぃん
tsl	つぉん
tso	つぉ
tsp	つぉう
tsq	つぁい
tsu	つ
tsw	つぇい
tsx	つぁう
tsz	つぁん
tt	てた
tu	とぅ
tw	てい
tx	たう
tyj	てゅん
tyu	てゅ
tz	たん
u	う
va	う゛ぁ
vd	う゛ぇん
ve	う゛ぇ
vi	う゛ぃ
vj	う゛ん
vk	う゛ぃん
vl	う゛ぉん
vo	う゛ぉ
vp	う゛ぉう
vq	う゛ぁい
vu	う゛
vw	う゛ぇい
vx	う゛ぁう
vz	う゛ぁん
w;	わった
wa	わ
wd	うぇん
we	うぇ
whe	ゑ
whi	ゐ
who	うぉ
wi	うぃ
wk	うぃん
wl	うぉん
wn	わん
wo	を
wp	うぉー
wq	わい
ww	w	w
wx	わう
wz	わん
x;	しい
xa	しゃ
xc	しゃい
xd	しぇん
xe	しぇ
xf	しぇ
xh	しゅう
xi	し
xj	しゅん
xk	しん
xl	しょん
xo	しょ
xp	しょう
xq	しゃい
xu	しゅ
xv	しぇい
xw	しぇい
xx	しゃう
xz	しゃん
y;	やった
ya	や
yd	いぇん
ye	いぇ
yf	ゆう
yi	よる
yj	ゆん
yl	よん
yo	よ
yp	よう
yq	やい
yr	やる
yt	よって
yu	ゆ
yw	いぇい
yx	やう
yy	やや
yz	やん
za	ざ
zb	ざい
zc	ざ
zd	ぜん
ze	ぜ
zf	ぜ
zh	ずう
zi	ずぃ
zj	ずん
zk	ずぃん
zl	ぞん
zn	ざん
zo	ぞ
zp	ぞう
zq	ざい
zu	ず
zv	ぜい
zw	ぜい
zx	ざう
zz	ざん
